11111111111111
1EE11111111001
10C11111111001
10011111111001
1000P000000001
10F111111110F1
10011111111001
10011111111001

10F111111110F1
10011111111001
10011111111001
10F000000000F1
10011111111001
10F111111110F1
10011111111001
10000000000001
11111111111111