111111111
100000001
111110001
1111100F1
111110001
100000001
111110F01
111110001
1111100F1
111110001
111110F01
111110001
111110F01
111110001
100000001
111110F01
111110001
11111CPE1
111111111