11111111111111
1EE11111111C01
1C011111111001
10011111111001
1000PC000C00C1
10F11111111001
100111111110F1
10011111111C01
10F11111111001
100111111110F1
10011111111C01
10F00000000001
100111111110F1
10011111111C01
1CF111111110F1
11111111111111