1111111111111111111
1P00000000000000101
101111111C1111111E1
1000000000000000001
100F0F0F0F0F0F0F001
101111111C111111101
1000000000000000001
1111111111111111111